111111111111111
100M00001E10001
1001C0001010101
1M0100C00000001
10010M0P0010C01
10M000000010001
111111111111111