11111111111
100000001E1
1001C000101
1C010000001
10010000001
100000CP001
11111111111