111111111111111
1M0000001E10001
1001C0001010C01
1C010M00M000001
1001000C0010001
10M000CP0010C01
111111111111111