111111111111111
100M00001E10001
1001C0001010101
1M0100C00000P01
10C00M000010C01
100000000010001
111111111111111
